p "First Maze" "A boring little maze." 2.0 2.0 2.0  4 4 4
//Generated by MazeTranslator from file mazes/firstmaze.maze

a "g f"
a "s 0  1.0 5.0 1.0  0 0 -1 0 1 0 1 0 0"
a "s 1  5 1 5  0 0 -1 0 1 0 1 0 0"
a "s 2  5 3 3  -1 0 0 0 1 0 0 0 -1"
a "s 3  1 1 5  0 0 -1 0 1 0 1 0 0"
a "s 4  1 1 3  1 0 0 0 1 0 0 0 1"
a "s 5  5 5 1  0 0 1 0 1 0 -1 0 0"
a "s 6  3 3 5  0 0 1 0 1 0 -1 0 0"
a "s 7  3 5 5  1 0 0 0 1 0 0 0 1"
a "s 8  3 1 1  0 0 1 0 1 0 -1 0 0"
a "s 9  5 5 3  0 0 1 0 1 0 -1 0 0"

l a  255 255 255
l d  255 255 255  1.0 -1.0 1.0

s 0,0,0 1,0,0 1,0,1 0,0,1 0 0
s 0,0,0 0,1,0 1,1,0 1,0,0 0 1
s 0,0,0 0,1,0 0,1,1 0,0,1 0 2

t rel:textures/maze.png 0 0
t col:0,0,0 0 1 b
t rel:textures/end.png 0 2
t rel:textures/start.png 0 3

//entrance and exit
d 2 3  0.05 2 0
d 2 2  2.95 0 2

//maze tiles
d 2 0  0 0 0
d 2 1  0 0 0
d 0 0  0 0 0
d 0 1  0 0 0
d 1 0  0 0 0
d 1 1  0 0 0
d 2 0  0 0 1
d 2 1  0 0 1
d 0 0  0 0 1
d 0 1  0 0 1
d 2 0  0 0 2
d 2 1  0 0 2
d 0 0  0 0 2
d 0 1  0 0 2
d 1 0  0 0 2
d 1 1  0 0 2
d 1 0  0 0 3
d 1 1  0 0 3
d 2 0  1 0 0
d 2 1  1 0 0
d 0 0  1 0 0
d 0 1  1 0 0
d 1 0  1 0 0
d 1 1  1 0 0
d 2 0  1 0 1
d 2 1  1 0 1
d 0 0  1 0 1
d 0 1  1 0 1
d 1 0  1 0 1
d 1 1  1 0 1
d 0 0  1 0 2
d 0 1  1 0 2
d 1 0  1 0 3
d 1 1  1 0 3
d 2 0  2 0 0
d 2 1  2 0 0
d 0 0  2 0 0
d 0 1  2 0 0
d 1 0  2 0 0
d 1 1  2 0 0
d 2 0  3 0 0
d 2 1  3 0 0
d 2 0  2 0 1
d 2 1  2 0 1
d 0 0  2 0 1
d 0 1  2 0 1
d 2 0  3 0 1
d 2 1  3 0 1
d 2 0  2 0 2
d 2 1  2 0 2
d 0 0  2 0 2
d 0 1  2 0 2
d 2 0  3 0 2
d 2 1  3 0 2
d 1 0  2 0 3
d 1 1  2 0 3
d 2 0  0 1 0
d 2 1  0 1 0
d 1 0  0 1 0
d 1 1  0 1 0
d 2 0  0 1 1
d 2 1  0 1 1
d 0 0  0 1 1
d 0 1  0 1 1
d 1 0  0 1 1
d 1 1  0 1 1
d 2 0  0 1 2
d 2 1  0 1 2
d 0 0  0 1 2
d 0 1  0 1 2
d 1 0  0 1 3
d 1 1  0 1 3
d 1 0  1 1 0
d 1 1  1 1 0
d 1 0  1 1 1
d 1 1  1 1 1
d 0 0  1 1 2
d 0 1  1 1 2
d 1 0  1 1 2
d 1 1  1 1 2
d 1 0  1 1 3
d 1 1  1 1 3
d 2 0  2 1 0
d 2 1  2 1 0
d 1 0  2 1 0
d 1 1  2 1 0
d 2 0  3 1 0
d 2 1  3 1 0
d 2 0  2 1 1
d 2 1  2 1 1
d 0 0  2 1 1
d 0 1  2 1 1
d 1 0  2 1 1
d 1 1  2 1 1
d 2 0  3 1 1
d 2 1  3 1 1
d 2 0  2 1 2
d 2 1  2 1 2
d 0 0  2 1 2
d 0 1  2 1 2
d 2 0  3 1 2
d 2 1  3 1 2
d 1 0  2 1 3
d 1 1  2 1 3
d 2 0  0 2 0
d 2 1  0 2 0
d 0 0  0 2 0
d 0 1  0 2 0
d 1 0  0 2 0
d 1 1  0 2 0
d 0 0  0 3 0
d 0 1  0 3 0
d 2 0  0 2 1
d 2 1  0 2 1
d 0 0  0 3 1
d 0 1  0 3 1
d 2 0  0 2 2
d 2 1  0 2 2
d 0 0  0 2 2
d 0 1  0 2 2
d 0 0  0 3 2
d 0 1  0 3 2
d 1 0  0 2 3
d 1 1  0 2 3
d 2 0  1 2 0
d 2 1  1 2 0
d 1 0  1 2 0
d 1 1  1 2 0
d 0 0  1 3 0
d 0 1  1 3 0
d 2 0  1 2 1
d 2 1  1 2 1
d 0 0  1 2 1
d 0 1  1 2 1
d 0 0  1 3 1
d 0 1  1 3 1
d 0 0  1 2 2
d 0 1  1 2 2
d 0 0  1 3 2
d 0 1  1 3 2
d 1 0  1 2 3
d 1 1  1 2 3
d 1 0  2 2 0
d 1 1  2 2 0
d 0 0  2 3 0
d 0 1  2 3 0
d 2 0  3 2 0
d 2 1  3 2 0
d 0 0  2 2 1
d 0 1  2 2 1
d 1 0  2 2 1
d 1 1  2 2 1
d 0 0  2 3 1
d 0 1  2 3 1
d 2 0  3 2 1
d 2 1  3 2 1
d 1 0  2 2 2
d 1 1  2 2 2
d 0 0  2 3 2
d 0 1  2 3 2
d 2 0  3 2 2
d 2 1  3 2 2
d 1 0  2 2 3
d 1 1  2 2 3

//end
